00000000000000000000000000000000
00000000000000000000000000000000
00000000000000000000000000000000
00000000000000000000000000000000
00000000000001000000000000000000
00000000000021103000000000000000
0000000000011010A000000000000000
000000000000B0106100000000000000
00000000001110100300000000000000
00000000001065110000000000000000
00000000000041113000000000000000
00000000000010210000000000000000
00000000000011110000000000000000
00000000000001000000000000000000
00000000000000000000000000000000
00000000000000000000000000000000
00000000000000000000000000000000
00000000000000000000000000000000
