00000000000000000000000000000000
00000000000000000000000000000000
00000000000000000811000000000000
00000000000000000001300000000000
00000000000000000047000000000000
00000000000000001110000000000000
00000000000000002011100000000000
00000000000003000010000000000000
00000000000411000310000000000000
00000000000101100011000000000000
00000000001101000111000000000000
00000000000B11000010000000000000
00000000000006150010000000000000
00000000000000061111000000000000
00000000000000001010000000000000
00000000000000000020000000000000
00000000000000000000000000000000
00000000000000000000000000000000